type octile
height 7
width 6
map
...TTT
.T.TTT
...TTT
TT..TT
TTT...
TTT.T.
TTT...