type octile
height 6
width 4
map
.TTT
....
.TTT
.TTT
.TTT
.TTT